popAsample1	GCATG
popAsample2	AACCA
popAsample3	CGATC
popAsample4	TCGAT
popAsample5	TGCAT
popAsample6	CAACC
popAsample7	GGTTG
popBsample1	AAGGA
popBsample2	AGCTA
popBsample3	ACACA
popBsample4	AATTA
popBsample5	ACGGT
popBsample6	ACTGG
popCsample1	ACTTC
popCsample2	ATACG
popCsample3	ATGAG
popDsample1	ATTAC
popDsample2	CATAT
popDsample3	CGAAT
popDsample4	CGGCT
popEsample1	CGGTA
popEsample2	CGTAC
popEsample3	CGTCG
popEsample4	CTGAT
popFsample1	CTGCG
popFsample2	CTGTC
popFsample3	CTTGG
popFsample4	GACAC	
